ろうせい	老成 (na-adj) — 老成; 老练
ろうこう	老巧 (na-adj) — 老练巧妙
ろうする	弄する (vs) — 玩弄; 操纵
ろうしょう	労相 (noun) — 劳相（劳动大臣）
ろうきほう	労基法 (noun) — 劳动基准法
ろうわ	漏話 (noun) — 漏话
ろうろう	浪々 (adv) — 飘零
ろんきゃく	論客 (noun) — 论客
ろんこう	論考 (noun) — 论文; 论考
わしゅうごう	和集合 (noun) — 并集
わんぱく	腕白 (na-adj) — 顽皮
あんぜん	暗然 (na-adj) — 黯然
さんぽう	算法 (noun) — 算法（古）
いぎぶかい	意義深い (na-adj) — 意义深远
いちぎてき	一義的 (na-adj) — 单义的; 明确的
いっこだにしない	一顧だにしない (expr) — 不屑一顾
いちげんか	一元化 (verb-noun) — 一元化
いつざい	逸材 (noun) — 奇才
いんよう	引用 (verb-noun) — 引用
うせつ	右折 (verb-noun) — 右转
ゆうきようばい	有機溶媒 (noun) — 有机溶剂
ゆうせんけん	優先権 (noun) — 优先权
ゆうえつかん	優越感 (noun) — 优越感
よそ	余所 (noun) — 别处; 他处
よそくかのうせい	予測可能性 (noun) — 可预测性
よくようきごう	抑揚記号 (noun) — 语调符号
おちぼひろい	落穂拾い (noun) — 拾穗; 拾遗
らんしょう	濫觴 (noun) — 滥觞; 根源
りしゅう	履修 (verb-noun) — 修读
りえきゆうどう	利益誘導 (noun) — 利益引导
りょうさいけんぼ	良妻賢母 (noun) — 贤妻良母
りんけん	臨検 (verb-noun) — 临检
るいご	類語 (noun) — 类语; 同义词
れいげん	冷厳 (na-adj) — 冷峻; 严峻
れいさいか	零細化 (verb-noun) — 细碎化
ろうそほう	労組法 (noun) — 工会法
ろうし	労使 (noun) — 劳资
ろうれい	老齢 (noun) — 高龄
ろうにんせいかつ	浪人生活 (noun) — 复读生活/待业
ろんせつ	論説 (noun) — 评论; 论文
わぶんわやく	和文和訳 (noun) — 日文互译
うできき	腕利き (na-adj) — 能干; 有本事
あんうん	暗雲 (noun) — 乌云
さんだん	算段 (verb-noun) — 筹划
いわかん	違和感 (noun) — 违和感
いっけん	一見 (adv) — 乍看
いっこうに	一向に (adv) — 丝毫（不）
いっきょりょうとく	一挙両得 (noun) — 一举两得
いっしつ	逸失 (noun) — 丧失
いんようぶん	引用文 (noun) — 引文
うおうさおうする	右往左往する (vs) — 慌乱
ゆうりふり	有利不利 (noun) — 有利与不利
ゆうせんじゅんい	優先順位 (noun) — 优先顺序
よだん	余談 (noun) — 题外话
よそうがい	予想外 (na-adj) — 意外
おさえこむ	抑え込む (v1) — 压制
らっかせい	落花生 (noun) — 花生
らんぴ	濫費 (verb-noun) — 浪费
りしゅうとうろく	履修登録 (noun) — 选课注册
りえきそうはん	利益相反 (noun) — 利益冲突
りょうさく	良策 (noun) — 良策
りんしょうしんり	臨床心理 (noun) — 临床心理
るいすいほう	類推法 (noun) — 类推法
れいしょう	冷笑 (verb-noun) — 冷笑
れいさいじぎょうしゃ	零細事業者 (noun) — 小微经营者
ろうしかんけい	労使関係 (noun) — 劳资关系
ろうしょうしゅうにん	労相就任 (noun) — 就任劳动大臣
ろうかい	老獪 (na-adj) — 老奸巨猾
ろうひぐせ	浪費癖 (noun) — 浪费习惯
ろんそう	論争 (verb-noun) — 论争
わよう	和洋 (noun) — 和洋
うでたてふせ	腕立て伏せ (noun) — 俯卧撑
あんごうかぎ	暗号鍵 (noun) — 加密密钥
さんよう	算用 (noun) — 算用; 计算
いけん	違憲 (na-adj) — 违宪
いっかげん	一家言 (noun) — 独到见解
いっきとうせん	一騎当千 (noun) — 一骑当千
いつだつこうい	逸脱行為 (noun) — 越轨行为
いんようく	引用句 (noun) — 引句
うせつきんし	右折禁止 (noun) — 禁止右转
ゆうけんしゃ	有権者 (noun) — 选民
ゆうじゅうふだん	優柔不断 (na-adj) — 优柔寡断
よち	余地 (noun) — 余地
よそくふのう	予測不能 (na-adj) — 不可预测
よくあつてき	抑圧的 (na-adj) — 压抑的
らくたんぎみ	落胆気味 (na-adj) — 略显沮丧
らんけい	濫刑 (noun) — 滥刑
りこうふのう	履行不能 (noun) — 不能履行
りえききょうよ	利益供与 (noun) — 利益输送
りょうひ	良否 (noun) — 好坏
りんしょうしけん	臨床試験 (noun) — 临床试验
るいすいすいろん	類推推論 (noun) — 类推推理
れいさいてん	零細店 (noun) — 小店
ろうしょうかんてい	労相官邸 (noun) — 劳动相官邸
ろうれいねんきん	老齢年金 (noun) — 高龄年金
ろうひど	浪費度 (noun) — 浪费度
ろんしょう	論証 (verb-noun) — 论证
わぎ	和議 (noun) — 和议
うでくらべ	腕比べ (noun) — 比本事
あんごうがく	暗号学 (noun) — 密码学
さんぽうてき	算法的 (na-adj) — 算法的
いはん	違反 (verb-noun) — 违反
いっかだんらん	一家団欒 (noun) — 天伦之乐
いっけいをあんずる	一計を案ずる (expr) — 想一计
いっきょしゅいっとうそく	一挙手一投足 (noun) — 一举一动
いつだつりつ	逸脱率 (noun) — 越轨率
いんようもと	引用元 (noun) — 出处
うはせいりょく	右派勢力 (noun) — 右翼势力
ゆうきのうぎょう	有機農業 (noun) — 有机农业
ゆうえつてきちい	優越的地位 (noun) — 优势地位
よぶん	余分 (na-adj) — 多余
よけんかのう	予見可能 (na-adj) — 可预见
よくしせいさく	抑止政策 (noun) — 威慑政策
らっかさん	落下傘 (noun) — 降落伞
らんぱつ	濫発 (verb-noun) — 滥发
りしゅうようけん	履修要件 (noun) — 修读要求
りえきそうはんかんけい	利益相反関係 (noun) — 利益冲突关系
りょうしつか	良質化 (verb-noun) — 高质量化
りんじょうかん	臨場感 (noun) — 临场感
るいすいのうりょく	類推能力 (noun) — 类推能力
れいらくきぞく	零落貴族 (noun) — 没落贵族
ろうえきけい	労役刑 (noun) — 劳役刑
ろうしふんそう	労使紛争 (noun) — 劳资纠纷
ろうれいか	老齢化 (noun) — 老龄化
ろうきょくし	浪曲師 (noun) — 浪曲师
ろんりせい	論理性 (noun) — 逻辑性
わかいあん	和解案 (noun) — 和解方案
わんそう	腕相 (noun) — 腕相
あんしょう	暗礁 (noun) — 暗礁
さんぽうろん	算法論 (noun) — 算法论
いやくきん	違約金 (noun) — 违约金
いっきょこうかい	一挙公開 (noun) — 一次性公开
いちげんかんり	一元管理 (noun) — 一元管理
いつわしゅう	逸話集 (noun) — 轶事集
いんようじょうほう	引用情報 (noun) — 引用信息
みぎななめ	右斜め (na-adj) — 右斜
ゆうけいこていしさん	有形固定資産 (noun) — 有形固定资产
ゆうぐうそち	優遇措置 (noun) — 优惠措施
よゆうしきん	余裕資金 (noun) — 富余资金
よびえき	予備役 (noun) — 预备役
よくあつかん	抑圧感 (noun) — 压抑感
らくさかくだい	落差拡大 (noun) — 差距扩大
らんぞうひん	濫造品 (noun) — 滥制品
りしゅうりれき	履修履歴 (noun) — 修读履历
りえきりつ	利益率 (noun) — 利润率
りょうしき	良識 (noun) — 良识
りんかいじこ	臨界事故 (noun) — 临界事故
るいすいとうけい	類推統計 (noun) — 推断统计
れいじ	零時 (noun) — 零时
ろうちん	労賃 (noun) — 工钱; 劳务费
しにせりょかん	老舗旅館 (noun) — 老字号旅馆
ろうわぼうし	漏話防止 (noun) — 防窃听
なにわ	浪速 (noun) — 浪速（大阪古称）
ろんしめいかい	論旨明快 (na-adj) — 论旨明快
わぶんちゅうしゃく	和文注釈 (noun) — 日文注释
わんぱくぼうず	腕白坊主 (noun) — 淘气包
あんき	暗記 (verb-noun) — 死记
さんしゅつ	算出 (verb-noun) — 算出
いわ	違和 (na-adj) — 不协调
いちあん	一案 (noun) — 一案
いっかつばらい	一括払い (noun) — 一次性付款
いちはや	逸早 (na-adj) — 尽早（口误）
いんようさき	引用先 (noun) — 引用来源
うきさんしょう	右記参照 (noun) — 参见右侧
ゆうえきせい	有益性 (noun) — 有益性
ゆうれつ	優劣 (noun) — 优劣
よいん	余韻 (noun) — 余韵
よびちしき	予備知識 (noun) — 预备知识
よくうつ	抑鬱 (na-adj) — 抑郁
らくさぜせい	落差是正 (noun) — 差距矫正
らんばつきんし	濫伐禁止 (noun) — 禁止滥伐
りしゅうようらん	履修要覧 (noun) — 修读指南
りえきはいぶん	利益配分 (noun) — 利益分配
りょうえん	良縁 (noun) — 良缘
りんきおうへん	臨機応変 (na-adj) — 随机应变
るいすいけんてい	類推検定 (noun) — 推断检验
れいらくぶり	零落ぶり (noun) — 衰落情状
ろうそかんぶ	労組幹部 (noun) — 工会干部
ろうせい	労政 (noun) — 劳动政策
ろうきょう	老境 (noun) — 暮年
ろまんてき	浪漫的 (na-adj) — 浪漫的
ろんそうてん	論争点 (noun) — 争议焦点
わやくちゅう	和訳注 (noun) — 译注
うでわ	腕輪 (noun) — 手镯
あんじてき	暗示的 (na-adj) — 暗示的
そろばんかんじょう	算盤勘定 (noun) — 算盘打得精
いけんしんさ	違憲審査 (noun) — 违宪审查
いちがいに	一概に (adv) — 一概地
いっこ	一顧 (noun) — 一顾
いつわてき	逸話的 (na-adj) — 轶事的
いんようけん	引用権 (noun) — 引用权
うはてき	右派的 (na-adj) — 右翼的
ゆうきしつ	有機質 (noun) — 有机质
すぐれもの	優れ物 (noun) — 好东西
よそごと	余所事 (noun) — 旁人之事
よびひわく	予備費枠 (noun) — 预备费额度
よくようほう	抑揚法 (noun) — 抑扬法
らくさしゅくしょう	落差縮小 (noun) — 差距缩小
らんぞうぎみ	濫造気味 (na-adj) — 略显滥造
りしゅうかもく	履修科目 (noun) — 修读科目
